1111111111111111111111111111
1E0000000000000C000000000001
1010010000100000101000010101
1010000N0010101000000N000101
1000000000000000000000000001
1P0000000C00C0000000000000C1
1111111111111111111111111111